2111111111111111111111111111111111111112
1000000000000000000000000000000000000001
1000000000000000000000000000000000000001
1000000000000000000000000000000000000001
1000000000000000000000000000000000000001
1000000000000000000000000000000000000001
1000000000000000000000000000000000000001
1000000000000000000000110000000000000001
1000000000000000000000110000000000000001
1000000000000001111111221111000000000001
1000000000000000000000110000000000000001
1000000000000000000000110000000000000001
1000000000000000000000110000000000000001
1000000000000000000000110000000000000001
1000000000000000000000110000000000000001
1000000000000000000000110000000000000001
1000000000000000000000110000000000000001
1000000000000000000000000000000000000001
1000000000000000000000000000000000000001
1000000000000000000000000000000000000001
1000000000000000000000000000000000000001
1000000000000000000000000000000000000001
1000000000000000000000000000000000000001
1000000000000000000000000000000000000001
1000000000000000000000000000000000000001
1000000000000000000000000000000000000001
1000000000000000000000000000000000000001
1000000000000000000000000000000000000001
1000000000000000000000000000000000000001
2111111111111111111111111111111111111112
