2222222222222222222222222222222222222222
2000000000000000000000000000000000000002
2000000000000000000000000000000000000002
2000000000000000000000000000000000000002
2000000000000000000000000000000000000002
2000000000000000000000000000000000000002
2000000000000000000000000000000000000002
2000000000000000000000110000000000000002
2000000000000000000000110000000000000002
2000000000000001111111221111000000000002
2000000000000000000000110000000000000002
2000000000000000000000110000000000000002
2000000000000000000000110000000000000002
2000000000000000000000110000000000000002
2000000000000000000000110000000000000002
2000000000000000000000110000000000000002
2000000000000000000000110000000000000002
2000000000000000000000000000000000000002
2000000000000000000000000000000000000002
2000000000000000000000000000000000000002
2000000000000000000000000000000000000002
2000000000000000000000000000000000000002
2000000000000000000000000000000000000002
2000000000000000000000000000000000000002
2000000000000000000000000000000000000002
2000000000000000000000000000000000000002
2000000000000000000000000000000000000002
2000000000000000000000000000000000000002
2000000000000000000000000000000000000002
2222222222222222222222222222222222222222
