1111111111111111111111111111111111111111
1000000000000000000000000000000000000001
1000000000000000000000000000000000000001
1000000000000111111111100000000000000001
1000000000000000000000100000000000000001
1000000000000000000000100000000000000001
1000000000000000000000100000000000000001
1000000000000000000000000000000000000001
1000000000111111111111111111000000000001
1000000000000000000100000000000000000001
1000000000000000000100000000000000000001
1000000000000000000100000000000000000001
1000000000000001111111110000000000000001
1000000000000000000000010000000000000001
1000000000000000000000010000000000000001
1000000000000000000000010000000000000001
1000000000000000000000000000000000000001
1000000000000000000000000000000000000001
1000000000000000000000001000000000000001
1000000000222222220000001000000000000001
1000000000200000020000001000000000000001
1000000000200000020000001000000000000001
1000000000200000020000001000000000000001
1000000000222222220000001000000000000001
1000000000000000000000001000000000000001
1000000000000000100000000000000000000001
1000000000000000100000000000000000000001
1000000000000000111111111100000000000001
1000000000000000000000000000000000000001
1111111111111111111111111111111111111111
