2222222222222222222222222222222222222222
2000000000000000000000000000000000000002
2000000000000000000000000000000000000002
2000000000000000000000000000000000000002
2000000011111111000000011111111000000002
2000000100000000100000100000000100000002
2000001000000000010001000000000010000002
2000010000000000001010000000000001000002
2000010000000000000100000000000001000002
2000010000000000000000000000000001000002
2000010000000000000000000000000001000002
2000001000000000000000000000000100000002
2000000110000000000000000000011000000002
2000000001100000000000000001100000000002
2000000000011000000000000110000000000002
2000000000000110000000011000000000000002
2000000000000001110011100000000000000002
2000000000000000001100000000000000000002
2000000000000000000000000000000000000002
2000000000000000000000000000000000000002
2000000000000000000000000000000000000002
2000000000000000000000000000000000000002
2000000000000000000000000000000000000002
2000000000000000000000000000000000000002
2000000000000000000000000000000000000002
2000000000000000000000000000000000000002
2000000000000000000000000000000000000002
2000000000000000000000000000000000000002
2000000000000000000000000000000000000002
2222222222222222222222222222222222222222
