2222222222222222222222222222222222222222
2000000000000000000000000000000000000002
2000000000000000000000000000000000000002
2000000000000000000000000000000000000002
2000000000000000000000000000000010000002
2000000000000000000000000000000000000002
2000000000000000000000000000000000000002
2000000000000000000000000000000000000002
2000000000000000000000000000000000000002
2000000000000000000000000000000000000002
2000000000000000000000000000000000000002
2000000000000000000100000000000000000002
2000000000000000000100000000000000000002
2000000000000000000100000000000000000002
2000000000000000000100000000000000000002
2000000000000000000100000000000000000002
2000000000000000000111111111000000000002
2000000000000000000000000000000000000002
2000000000000000000000000000000000000002
2000000000000000000000000000000000000002
2000000000000000000000000000000000000002
2000000000000000000000000000000000000002
2000000000000000000000000000000000000002
2000000000000000000000000000000000000002
2000000000000000000000000000000000000002
2000000000000000000000000000000000000002
2000000000000000000000000000000000000002
2000000000000000000000000000000000000002
2000000000000000000000000000000000000002
2222222222222222222222222222222222222222
